Я знаю.	I know.	Ya znayu.
Я тебе кохаю.	I love you.	Ya tebe kokhayu.
Він працює.	He works.	Vin pratsyuye.
Вона чекає.	She waits.	Vona chekaye.
Воно не працює.	It not work.	Vono ne pratsyuye.
Ми чекаємо.	We wait.	My chekayemo.
Ви працюєте.	You work.	Vy pratsyuyete.
Вони знають.	They know.	Vony znayut'.
Я не знаю цей.	I not know this.	Ya ne znayu tsey.
Я знаю той.	I know that.	Ya znayu toy.
Всі працюють.	All work.	Vsi pratsyuyut'.
Що це?	What this?	Shcho tse?
Хто ти?	Who you?	Khto ty?
Де ви?	Where you?	De vy?
Чому ти чекаєш?	Why you wait?	Chomu ty chekayesh?
Як ти?	How you?	Yak ty?
Який це?	Which this?	Yakyy tse?
Коли ти приходиш?	When you come?	Koly ty prykhodysh?
Якщо ти чекаєш, я приходжу.	If you wait, I come.	Yakshcho ty chekayesh, ya prykhodžu.
Я знаю, але ти не знаєш.	I know, but you not know.	Ya znayu, ale ty ne znayesh.
Я чекаю, тому що я тебе кохаю.	I wait, because I love you.	Ya chekayu, tomu shcho ya tebe kokhayu.
Ти або вона?	You or she?	Ty abo vona?
Ти і я.	You and I.	Ty i ya.
Ти приходиш, тоді ми розмовляємо.	You come, then we talk.	Ty prykhodysh, todi my rozmovlyayemo.
Ти дійсно працюєш?	You really work?	Ty diysno pratsyuyesh?
Я не знаю.	I not know.	Ya ne znayu.
Я знаю це.	I know this.	Ya znayu tse.
Я думаю, що ти працюєш.	I think, that you work.	Ya dumayu, shcho ty pratsyuyesh.
Ти приходиш?	You come?	Ty prykhodysh?
Я класту це.	I put this.	Ya klastu tse.
Я беру це.	I take this.	Ya beru tse.
Я знаходжу це.	I find this.	Ya znakhodzhu tse.
Ти слухаєш?	You listen?	Ty slukhayesh?
Ми працюємо.	We work.	My pratsyuyemo.
Ми розмовляємо.	We talk.	My rozmovlyayemo.
Я даю це.	I give this.	Ya dayu tse.
Я люблю це.	I like this.	Ya lyublyu tse.
Ти допомагаєш мені?	You help me?	Ty dopomahayesh meni?
Я тебе кохаю.	I love you.	Ya tebe kokhayu.
Я телефоную тобі.	I call you.	Ya telefоnuyu tobi.
Я чекаю тебе.	I wait you.	Ya chekayu tebe.
Я знаю нуль.	I know 0.	Ya znayu nul'.
Мені це потрібно.	I need this.	Meni tse potribno.
Скільки це коштує?	How much is this?	Skil'ky tse koshtuye?
Я знаю.	I know.	Ya znayu.
Я не знаю.	I don't know.	Ya ne znayu.
Ти мені подобаєшся.	I like you.	Ty meni podobayeshsya.
Мені це не подобається.	I don't like this.	Meni tse ne podobayet'sya.
Ти мене кохаєш?	Do you love me?	Ty mene kokhayesh?
Я тебе кохаю.	I love you.	Ya tebe kokhayu.