червоний	adjective	red	chervonyi
синій	adjective	blue	synii
зелений	adjective	green	zelenyi
жовтий	adjective	yellow	zhovtyi
повільний	adjective	slow	povilnyi
швидкий	adjective	quick	shvydkyi
кумедний	adjective	funny	kumednyi
несправедливий	adjective	unfair	nespravedlyvyi
справедливий	adjective	fair	spravedlyvyi
важкий	adjective	difficult	vazhkyi
легкий	adjective	easy	lehkyi
багатий	adjective	rich	bahatyi
бідний	adjective	poor	bidnyi
сильний	adjective	strong	sylnyi
слабкий	adjective	weak	slabkyi
безпечний	adjective	safe	bezpechnyi
втомлений	adjective	tired	vtomlenyy
гордий	adjective	proud	hordyi
ситий	adjective	full (from eating)	sytyi
хворий	adjective	sick	khvoryi
здоровий	adjective	healthy	zdorovyi
сердитий	adjective	angry	serdytyi
низький	adjective	low	nyzkyi
високий	adjective	high	vysokyi
прямий	adjective	straight (line)	priamyi
кожний	adverb	every	kozhnyi
завжди	adverb	always	zavzhdy
насправді	adverb	actually	naspravdi
знову	adverb	again	znovu
вже	adverb	already	vzhe
менше	adverb	less	menshe
найбільше	adverb	most	naibilshe
більше	adverb	more	bilshe
жоден	adverb	none	zhoden
дуже	adverb	very	duzhe
тварина	noun (F)	animal	tvaryna
свиня	noun (F)	pig	svynia
корова	noun (F)	cow	korova
кінь	noun (M)	horse	kin
собака	noun (M)	dog	sobaka
вівця	noun (F)	sheep	vivtsia
мавпа	noun (F)	monkey	mavpa
кішка	noun (F)	cat	kishka
ведмідь	noun (M)	bear	vedmid
курка	noun (F)	chicken (animal)	kurka
качка	noun (F)	duck	kachka
метелик	noun (M)	butterfly	metelyk
бджола	noun (F)	bee	bdzhola
Це важко	phrase	This is difficult	Tse vazhko
Я хочу ще	phrase	I want more	Ya khochu shche