я	pronoun	I	ya
ти	pronoun	you (singular)	ty
він	pronoun	he	vin
вона	pronoun	she	voná
воно	pronoun	it	vonó
ми	pronoun	we	my
ви	pronoun	you (plural)	vy
вони	pronoun	they	voný
цей	pronoun	this	tsey
той	pronoun	that	toy
всi	pronoun	all	vsi
що	question word	what	shcho
хто	question word	who	khto
де	question word	where	de
чому	question word	why	chomú
як	question word	how	yak
який	question word	which	yakýy
коли	question word	when	kolý
якщо	conjunction	if	yakshchó
але	conjunction	but	alé
тому що	conjunction	because	tomú shcho
або	conjunction	or	abó
і	conjunction	and	i
тоді	adverb	then	todí
дійсно	adverb	really	díysno
не	negation	not	ne
знати	verb	to know	znáty
думати	verb	to think	dúmaty
приходити	verb	to come	prykhódyty
класти	verb	to put	klásty
брати	verb	to take	bráty
знаходити	verb	to find	znakhódyty
слухати	verb	to listen	slúkhaty
працювати	verb	to work	pratsyuváty
розмовляти	verb	to talk	rozmovlyáty
давати	verb	to give	daváty
любити	verb	to like	lyubýty
допомагати	verb	to help	dopomaháty
кохати	verb	to love	kokháty
телефонувати	verb	to call	telefonuváty
чекати	verb	to wait	chekáty
нуль	number	0	nulʹ
Мені це потрібно	phrase	I need this	Mení tse potríbno
Скільки це коштує?	phrase	How much is this?	Skílʹky tse kóshtuye?
Я знаю	phrase	I know	Ya znáyu
Я не знаю	phrase	I don't know	Ya ne znáyu
Ти мені подобаєшся	phrase	I like you	Ty mení podóbayeshsya
Мені це не подобається	phrase	I don't like this	Mení tse ne podóbayetʹsya
Ти мене кохаєш?	phrase	Do you love me?	Ty mené kokháyesh?
Я тебе кохаю	phrase	I love you	Ya tebé kokháyu