один	numeral	1	odyn
два	numeral	2	dva
три	numeral	3	try
чотири	numeral	4	chotyry
п'ять	numeral	5	p'yat'
шість	numeral	6	shist'
сім	numeral	7	sim
вісім	numeral	8	visim
дев'ять	numeral	9	dev'yat'
десять	numeral	10	desyat'
одинадцять	numeral	11	odynadtsyat'
дванадцять	numeral	12	dvanadtsyat'
тринадцять	numeral	13	trynadtsyat'
чотирнадцять	numeral	14	chotyrnadtsyat'
п'ятнадцять	numeral	15	p'yatnadtsyat'
шістнадцять	numeral	16	shistnadtsyat'
сімнадцять	numeral	17	simnadtsyat'
вісімнадцять	numeral	18	visimnadtsyat'
дев'ятнадцять	numeral	19	dev'yatnadtsyat'
двадцять	numeral	20	dvadtsyat'
новий	adjective	new	novyy
старий	adjective	old (not new)	staryy
неправильний	adjective	wrong	nepravyl'nyy
правильний	adjective	correct	pravyl'nyy
поганий	adjective	bad	pohanyy
хороший	adjective	good	khoroshyy
щасливий	adjective	happy	shchaslyvyy
короткий	adjective	short (length)	korotkyy
довгий	adjective	long	dovhyy
маленький	adjective	small	malen'kyy
великий	adjective	big	velykyy
правий	adjective	right	pravyy
лівий	adjective	left	livyy
прекрасний	adjective	beautiful	prekrasnyy
молодий	adjective	young	molodyy
старий	adjective	old (not young)	staryy
мало	adverb	few	malo
багато	adverb	many	bahato
там	adverb	there	tam
тут	adverb	here	tut
скільки?	question word	how much?	skil'ky?
скільки?	question word	how many?	skil'ky?
вітаю	phrase	hello	vitayu
побачимось	phrase	see you later	pobachymos'
добре	phrase	ok	dobre
бережи себе	phrase	take care	berezhy sebe
не хвилюйся	phrase	don't worry	ne khvylyuysya
звичайно	phrase	of course	zvychayno
добрий день	phrase	good day	dobryy den'
привіт	phrase	hi	pryvit