мама	noun (F)	mum	mama
тато	noun (M)	dad	tato
мати	noun (F)	mother	maty
батько	noun (M)	father	batko
батьки	noun (PL)	parents	batky
син	noun (M)	son	syn
дочка	noun (F)	daughter	dochka
молодша сестра	noun (F)	little sister	molodsha sestra
молодший брат	noun (M)	little brother	molodshyy brat
старша сестра	noun (F)	big sister	starsha sestra
старший брат	noun (M)	big brother	starshyy brat
компанія	noun (F)	company	kompaniya
бізнес	noun (M)	business	biznes
робота	noun (F)	job	robota
гроші	noun (PL)	money	hroshi
телефон	noun (M)	telephone	telefon
офіс	noun (M)	office	ofis
доктор	noun (M)	doctor	doktor
лікарня	noun (F)	hospital	likarnya
медсестра	noun (F)	nurse	medsestra
поліцейський	noun (M)	policeman	politseyskyi
президент	noun (M)	president	prezydent
питання	noun (N)	question	pytannya
стояти	verb	to stand	stoyaty
сидіти	verb	to sit	sydity
лежати	verb	to lie	lezhaty
закривати	verb	to close	zakryvaty
відкривати	verb	to open	vidkryvaty
програвати	verb	to lose	prohravaty
вигравати	verb	to win	vyhravaty
вмирати	verb	to die	vmyraty
жити	verb	to live	zhyty
вмикати	verb	to turn on	vmykaty
вимикати	verb	to turn off	vymykaty
вбивати	verb	to kill	vbyvaty
травмувати	verb	to injure	travmuvaty
доторкатися	verb	to touch	dotorkatysya
дивитися	verb	to watch	dyvytysya
пити	verb	to drink	pyty
їсти	verb	to eat	yisty
ходити	verb	to walk	khodyty
зустріти	verb	to meet	zustriti
битися об заклад	verb	to bet	bytysya ob zaklad
поцілувати	verb	to kiss	potsiluvaty
слідувати	verb	to follow	sliduvaty
одружуватись	verb	to marry	odruzhuvats
відповідати	verb	to answer	vidpovidaty
запитувати	verb	to ask	zapytuvaty
білий	adjective	white	bilyy
чорний	adjective	black	chornyy