риба	noun	fish	ryba
павук	noun	spider	pavuk
змія	noun	snake	zmiya
голова	noun	head	holova
ніс	noun	nose	nis
волосся	noun	hair	volossya
рот	noun	mouth	rot
вухо	noun	ear	vukho
око	noun	eye	oko
рука	noun	hand	ruka
ступня	noun	foot	stupnya
серце	noun	heart	sertse
мозок	noun	brain	mozok
передній	adjective	front	peredniy
задній	adjective	back (position)	zadniy
далекий	adjective	far	dalekiy
близький	adjective	close	blyz'kyy
солодкий	adjective	sweet	solodkyy
кислий	adjective	sour	kyslyy
м'який	adjective	soft	m'yakyy
твердий	adjective	hard	tverdyy
високий	adjective	tall	vysokyy
низький	adjective	short (height)	nyz'kyy
холодний	adjective	cold	kholodnyy
спекотний	adjective	hot (temperature)	spekotnyy
милий	adjective	cute	mylyy
тупий	adjective	stupid	tupyy
божевільний	adjective	crazy	bozhevil'nyy
зайнятий	adjective	busy	zaynyatyy
стурбований	adjective	worried	sturbovanyy
здивований	adjective	surprised	zdyvovanyy
крутий	adjective	cool	krutyy
гречний	adjective	well-behaved	hrechnyy
злий	adjective	evil	zlyy
розумний	adjective	clever	rozumnyy
дивний	adjective	strange	dyvnyy
тягнути	verb	to pull	tyahnuty
штовхати	verb	to push	shtovkhaty
натискати	verb	to press (a button)	natyskaty
бити	verb	to hit	byty
ловити	verb	to catch	lovyty
битися	verb	to fight	bytysya
кидати	verb	to throw	kydaty
бігати	verb	to run	bihaty
читати	verb	to read	chytaty
ззовні	adverb	outside	zzovni
всередині	adverb	inside	vseredyni
під	preposition	below	pid
над	preposition	above	nad
поруч	adverb	beside	poruch