бувай	phrase	bye bye	buvai
до побачення	phrase	good bye	do pobachennya
перепрошую	phrase	excuse me	pereproshyu
вибачте	phrase	sorry	vybachte
дякую	phrase	thank you	dyakuyu
будь ласка	phrase	please	bud' laska
я хочу це	phrase	I want this	ya khochu tse
зараз	adverb	now	zaraz
після обіду	adverb	afternoon	pislya obidu
ранок	noun (m)	morning (9:00-11:00)	ranok
ніч	noun (f)	night	nich
ранок	noun (m)	morning (6:00-9:00)	ranok
вечір	noun (m)	evening	vechir
полудень	noun (m)	noon	poluden'
північ	noun (f)	midnight	pivnich
година	noun (f)	hour	hodyna
хвилина	noun (f)	minute	khvylyna
секунда	noun (f)	second (time)	sekunda
день	noun (m)	day	den'
тиждень	noun (m)	week	tyzhden'
місяць	noun (m)	month	misyats'
рік	noun (m)	year	rik
час	noun (m)	time	chas
дата	noun (f)	date (time)	data
позавчора	adverb	the day before yesterday	pozavchora
вчора	adverb	yesterday	vchora
сьогодні	adverb	today	s'ohodni
завтра	adverb	tomorrow	zavtra
післязавтра	adverb	the day after tomorrow	pislyazavtra
понеділок	noun (m)	Monday	ponedilok
вівторок	noun (m)	Tuesday	vivtorok
середа	noun (f)	Wednesday	sereda
четвер	noun (m)	Thursday	chetver
п'ятниця	noun (f)	Friday	p'yatnytsya
субота	noun (f)	Saturday	subota
неділя	noun (f)	Sunday	nedilya
завтра субота	phrase	Tomorrow is Saturday	zavtra subota
життя	noun (n)	life	zhyttya
жінка	noun (f)	woman	zhinka
чоловік	noun (m)	man	cholovik
кохання	noun (n)	love	kokhannya
хлопець	noun (m)	boyfriend	khlopets'
дівчина	noun (f)	girlfriend	divchyna
друг	noun (m)	friend	druh
поцілунок	noun (m)	kiss	potsilunok
секс	noun (m)	sex	seks
дитина	noun (f)	child	dytyna
малюк	noun (m)	baby	malyuk
дівчина	noun (f)	girl	divchyna
хлопчик	noun (m)	boy	khlopchyk